12,13,43,5,16,16,16,16,16,16,16,16,16,16,16
5,6,9,10,0,0,0,0,0,0,0,0,0,0,0
21,14,9,10,0,0,0,0,0,0,0,0,0,0,0
38,39,16,17,0,0,0,0,0,0,0,0,0,0,0
0,0,0,0,0,0,0,0,0,0,0,0,0,33,32
0,0,0,0,0,0,0,0,0,0,25,25,25,36,13
0,0,0,0,0,0,0,0,0,0,0,0,0,8,9
0,0,0,0,0,0,0,0,0,1,2,2,2,13,43
2,2,2,2,2,2,2,2,2,13,44,9,9,9,5
9,43,9,9,9,9,9,43,9,9,9,9,9,5,45